-1
######
#..A.#
#..a.#
#.@a.#
#...@#
######
