5
 ######
##..BA#
#@aba.#
#@@b.#
#.@..#
######
